ClevelandCavaliers	1,NODE,30,IndianaPacers,MiamiHeat,HoustonRockets,LosAngelesLakers,MinnesotaTimberwolves,UtahJazz,TorontoRaptors,MilwaukeeBucks,NewOrleansHornets,OrlandoMagic,PortlandTrailBlazers,ChicagoBulls,DallasMavericks,WashingtonWizards,NewJerseyNets,PhoenixSuns,DenverNuggets,SanAntonioSpurs,GoldenStateWarriors,OklahomaCityThunder,AtlantaHawks,BostonCeltics
DetroitPistons	1,NODE,30,PortlandTrailBlazers,NewOrleansHornets,MinnesotaTimberwolves,ChicagoBulls,NewYorkKnicks,OrlandoMagic,DenverNuggets,HoustonRockets,LosAngelesLakers,OklahomaCityThunder,PhoenixSuns,SanAntonioSpurs,BostonCeltics,MemphisGrizzlies,LosAngelesClippers,MiamiHeat
SanAntonioSpurs	1,NODE,30,MemphisGrizzlies,OrlandoMagic,BostonCeltics
DenverNuggets	1,NODE,30,IndianaPacers,NewJerseyNets,OklahomaCityThunder,SanAntonioSpurs,Philadelphia76ers
WashingtonWizards	1,NODE,30,DenverNuggets,MilwaukeeBucks,DallasMavericks,LosAngelesLakers,MemphisGrizzlies,ChicagoBulls,MiamiHeat,TorontoRaptors,PhoenixSuns,SanAntonioSpurs,BostonCeltics,NewOrleansHornets,PortlandTrailBlazers,IndianaPacers,SacramentoKings,OrlandoMagic,OklahomaCityThunder,LosAngelesClippers,Philadelphia76ers,DetroitPistons,GoldenStateWarriors,NewYorkKnicks
TorontoRaptors	1,NODE,30,OrlandoMagic,IndianaPacers,DenverNuggets,DetroitPistons,ChicagoBulls,UtahJazz,SanAntonioSpurs,DallasMavericks,AtlantaHawks,PortlandTrailBlazers,MiamiHeat,CharlotteBobcats,GoldenStateWarriors,PhoenixSuns,MilwaukeeBucks,LosAngelesLakers,MemphisGrizzlies,BostonCeltics,NewYorkKnicks
NewJerseyNets	1,NODE,30,Philadelphia76ers,NewYorkKnicks,LosAngelesLakers,MinnesotaTimberwolves,DallasMavericks,MilwaukeeBucks,SanAntonioSpurs,AtlantaHawks,IndianaPacers,PhoenixSuns,OklahomaCityThunder,WashingtonWizards,HoustonRockets,MiamiHeat,NewOrleansHornets,BostonCeltics,OrlandoMagic,ChicagoBulls
CharlotteBobcats	1,NODE,30,BostonCeltics,MiamiHeat,SanAntonioSpurs,NewOrleansHornets,LosAngelesClippers,IndianaPacers,OrlandoMagic,ChicagoBulls,DallasMavericks,DenverNuggets,MemphisGrizzlies,PortlandTrailBlazers,MilwaukeeBucks,Philadelphia76ers,WashingtonWizards,OklahomaCityThunder
UtahJazz	1,NODE,30,DenverNuggets,DallasMavericks,AtlantaHawks,ChicagoBulls,NewYorkKnicks,OklahomaCityThunder,MiamiHeat,MemphisGrizzlies,SanAntonioSpurs,LosAngelesLakers,PhoenixSuns,BostonCeltics,WashingtonWizards,GoldenStateWarriors,PortlandTrailBlazers
SacramentoKings	1,NODE,30,LosAngelesLakers,MemphisGrizzlies,CharlotteBobcats,Philadelphia76ers,OklahomaCityThunder,NewOrleansHornets,MiamiHeat,UtahJazz,SanAntonioSpurs,DallasMavericks,BostonCeltics,DenverNuggets,ChicagoBulls,HoustonRockets,DetroitPistons,LosAngelesClippers
AtlantaHawks	1,NODE,30,DenverNuggets,SanAntonioSpurs,BostonCeltics,NewOrleansHornets,DallasMavericks,ChicagoBulls,OklahomaCityThunder,LosAngelesLakers,MiamiHeat,PhoenixSuns,HoustonRockets,Philadelphia76ers
NewYorkKnicks	1,NODE,30,HoustonRockets,DallasMavericks,BostonCeltics,MilwaukeeBucks,MiamiHeat,OrlandoMagic,LosAngelesLakers
OrlandoMagic	1,NODE,30,UtahJazz,AtlantaHawks,MiamiHeat,DenverNuggets,PortlandTrailBlazers
MemphisGrizzlies	1,NODE,30,NewYorkKnicks,AtlantaHawks,HoustonRockets,NewJerseyNets,OrlandoMagic,MiamiHeat,ChicagoBulls
MilwaukeeBucks	1,NODE,30,AtlantaHawks,MiamiHeat,UtahJazz,NewOrleansHornets,DenverNuggets,MemphisGrizzlies,PhoenixSuns,ChicagoBulls,DetroitPistons,PortlandTrailBlazers,BostonCeltics
LosAngelesLakers	1,NODE,30,CharlotteBobcats,MiamiHeat
Philadelphia76ers	1,NODE,30,DallasMavericks,OklahomaCityThunder,MemphisGrizzlies,BostonCeltics,MiamiHeat,LosAngelesLakers,SanAntonioSpurs,ChicagoBulls,MilwaukeeBucks
DallasMavericks	1,NODE,30,MilwaukeeBucks,ChicagoBulls,DenverNuggets,LosAngelesLakers,DetroitPistons,SanAntonioSpurs
IndianaPacers	1,NODE,30,BostonCeltics,ChicagoBulls,MinnesotaTimberwolves,SanAntonioSpurs,PhoenixSuns,LosAngelesLakers,NewOrleansHornets,Philadelphia76ers,MemphisGrizzlies,OklahomaCityThunder,AtlantaHawks,UtahJazz,HoustonRockets,OrlandoMagic
OklahomaCityThunder	1,NODE,30,TorontoRaptors,NewYorkKnicks,DallasMavericks,SanAntonioSpurs,OrlandoMagic
GoldenStateWarriors	1,NODE,30,OrlandoMagic,DallasMavericks,MiamiHeat,DenverNuggets,ChicagoBulls,LosAngelesLakers,AtlantaHawks,SanAntonioSpurs,BostonCeltics,MemphisGrizzlies,PhoenixSuns,HoustonRockets
MiamiHeat	1,NODE,30,DenverNuggets,DallasMavericks
BostonCeltics	1,NODE,30,ChicagoBulls,HoustonRockets
HoustonRockets	1,NODE,30,OklahomaCityThunder,Philadelphia76ers,DallasMavericks,OrlandoMagic,NewOrleansHornets,MiamiHeat,SanAntonioSpurs
MinnesotaTimberwolves	1,NODE,30,Philadelphia76ers,DallasMavericks,LosAngelesLakers,PhoenixSuns,LosAngelesClippers,SanAntonioSpurs,DenverNuggets,GoldenStateWarriors,MiamiHeat,HoustonRockets,AtlantaHawks,PortlandTrailBlazers,OklahomaCityThunder,MemphisGrizzlies,OrlandoMagic,SacramentoKings,ChicagoBulls
PortlandTrailBlazers	1,NODE,30,BostonCeltics,DenverNuggets,GoldenStateWarriors,AtlantaHawks,NewOrleansHornets,LosAngelesLakers
PhoenixSuns	1,NODE,30,CharlotteBobcats,OklahomaCityThunder,Philadelphia76ers,MiamiHeat,DallasMavericks,DenverNuggets,ChicagoBulls,MemphisGrizzlies,NewYorkKnicks,NewOrleansHornets,PortlandTrailBlazers,SanAntonioSpurs,OrlandoMagic
LosAngelesClippers	1,NODE,30,GoldenStateWarriors,OrlandoMagic,UtahJazz,HoustonRockets,NewOrleansHornets,NewJerseyNets,DallasMavericks,IndianaPacers,PhoenixSuns,ChicagoBulls,SanAntonioSpurs,MemphisGrizzlies,LosAngelesLakers,Philadelphia76ers,PortlandTrailBlazers,MilwaukeeBucks,MiamiHeat,AtlantaHawks
NewOrleansHornets	1,NODE,30,OklahomaCityThunder,ChicagoBulls,Philadelphia76ers,NewYorkKnicks,MemphisGrizzlies,GoldenStateWarriors,LosAngelesLakers,DallasMavericks,MinnesotaTimberwolves
